package Material;



/**
 *Clase para representar al laberinto
 * @author jessica
 */
public class Laberinto {
    
    
    private final int NUM_FILAS    = 45;
    private final int NUM_COLUMNAS = 45;  
    private int[][] matrizLaberinto;
    
    /**
     * Constructor por omision que crea una matriz de tamaño fijo
     */
    public Laberinto(){
        //matrizLaberinto = new int [NUM_FILAS][NUM_COLUMNAS];
    }
    /**
     * Metodo para obtener el laberinto
     * @return int [][] -- la matriz que presenta el laberinto.
     */
    public int[][] obtenerLaberinto(){
        return matrizLaberinto;
    }
    /**
     * Metodo para crear el laberinto.
     * Sustituye el contenido del metodo para generar laberintos aleatorios.
     */
    public void crearLaberinto() {
        matrizLaberinto = new int[][] {
        {1,1,1,1,1,1,1,1,1,1,1,1,1,1,1,1,1,1,1,1,1,1,1,1,1,1,1,1,1,1,1,1,1,1,1,1,1,1,1,1,1,1,1,1,1},
        {1,3,3,3,1,3,3,3,3,3,1,3,3,3,1,3,3,3,3,3,3,3,1,3,1,3,3,3,1,3,3,3,1,3,3,3,1,3,1,3,3,3,3,3,1},
        {1,1,1,3,1,1,1,3,1,1,1,1,1,3,1,3,1,1,1,1,1,3,1,3,1,1,1,3,1,3,1,1,1,3,1,1,1,3,1,3,1,1,1,1,1},
        {1,3,1,3,3,3,3,3,1,3,3,3,3,3,3,3,1,3,3,3,3,3,3,3,3,3,3,3,3,3,3,3,3,3,1,3,1,3,3,3,1,3,1,3,1},
        {1,3,1,1,1,1,1,3,1,3,1,3,1,1,1,1,1,1,1,1,1,1,1,1,1,1,1,1,1,3,1,3,1,3,1,3,1,1,1,3,1,3,1,3,1},
        {1,3,3,3,3,3,3,3,1,3,1,3,1,3,3,3,3,3,3,3,3,3,1,3,3,3,3,3,1,3,1,3,1,3,3,3,1,3,1,3,1,3,3,3,1},
        {1,1,1,1,1,3,1,3,1,3,1,1,1,3,1,1,1,3,1,1,1,3,1,3,1,1,1,3,1,1,1,1,1,3,1,3,1,3,1,3,1,3,1,1,1},
        {1,3,3,3,3,3,1,3,3,3,3,3,3,3,3,3,1,3,3,3,1,3,3,3,1,3,1,3,1,3,3,3,3,3,1,3,3,3,1,3,3,3,3,3,1},
        {1,3,1,1,1,1,1,1,1,1,1,1,1,3,1,1,1,3,1,1,1,1,1,3,1,3,1,1,1,1,1,3,1,3,1,1,1,1,1,3,1,1,1,1,1},
        {1,3,3,3,3,3,3,3,3,3,1,3,3,3,1,3,3,3,1,3,3,3,1,3,3,3,1,3,3,3,3,3,1,3,1,3,1,3,1,3,3,3,3,3,1},
        {1,3,1,1,1,1,1,3,1,1,1,1,1,1,1,1,1,3,1,1,1,3,1,3,1,3,1,1,1,3,1,3,1,1,1,3,1,3,1,3,1,3,1,1,1},
        {1,3,3,3,1,3,3,3,1,3,1,3,1,3,3,3,1,3,3,3,1,3,3,3,1,3,3,3,1,3,1,3,3,3,3,3,3,3,1,3,1,3,1,3,1},
        {1,3,1,1,1,1,1,3,1,3,1,3,1,3,1,3,1,3,1,1,1,3,1,3,1,1,1,1,1,3,1,1,1,1,1,3,1,1,1,1,1,3,1,3,1},
        {1,3,1,3,3,3,3,3,1,3,3,3,1,3,1,3,1,3,1,3,1,3,1,3,1,3,3,3,3,3,1,3,3,3,3,3,3,3,3,3,3,3,3,3,1},
        {1,1,1,1,1,3,1,1,1,1,1,3,1,1,1,3,1,1,1,3,1,1,1,1,1,3,1,3,1,1,1,3,1,1,1,3,1,1,1,1,1,3,1,3,1},
        {1,3,3,3,3,3,3,3,1,3,3,3,3,3,1,3,1,3,1,3,3,3,3,3,3,3,1,3,1,3,1,3,1,3,1,3,1,3,3,3,1,3,1,3,1},
        {1,3,1,1,1,3,1,3,1,1,1,1,1,3,1,3,1,3,1,3,1,1,1,3,1,3,1,1,1,3,1,1,1,3,1,3,1,1,1,3,1,1,1,1,1},
        {1,3,1,3,1,3,1,3,1,3,3,3,3,3,3,3,1,3,3,3,3,3,1,3,1,3,3,3,3,3,1,3,1,3,1,3,3,3,1,3,1,3,3,3,1},
        {1,3,1,3,1,1,1,3,1,1,1,1,1,3,1,3,1,3,1,3,1,3,1,1,1,3,1,1,1,3,1,3,1,3,1,1,1,1,1,3,1,1,1,3,1},
        {1,3,1,3,3,3,1,3,3,3,1,3,1,3,1,3,1,3,1,3,1,3,1,3,3,3,3,3,1,3,3,3,1,3,3,3,3,3,3,3,3,3,3,3,1},
        {1,1,1,3,1,1,1,1,1,1,1,3,1,3,1,3,1,3,1,1,1,1,1,1,1,3,1,3,1,1,1,1,1,1,1,1,1,3,1,1,1,3,1,3,1},
        {1,3,3,3,3,3,1,3,1,3,1,3,3,3,1,3,3,3,1,3,3,3,3,3,3,3,1,3,1,3,3,3,1,3,3,3,3,3,3,3,1,3,1,3,1},
        {1,1,1,3,1,3,1,3,1,3,1,3,1,3,1,3,1,1,1,1,1,3,1,1,1,1,1,3,1,3,1,1,1,1,1,3,1,1,1,1,1,3,1,1,1},
        {1,3,1,3,1,3,3,3,1,3,1,3,1,3,1,3,3,3,1,3,3,3,3,3,3,3,1,3,3,3,3,3,3,3,3,3,1,3,3,3,3,3,1,3,1},
        {1,3,1,3,1,3,1,1,1,3,1,1,1,3,1,1,1,1,1,1,1,1,1,1,1,3,1,1,1,1,1,1,1,3,1,1,1,3,1,1,1,1,1,3,1},
        {1,3,3,3,1,3,3,3,3,3,3,3,1,3,1,3,3,3,3,3,3,3,1,3,1,3,1,3,3,3,3,3,3,3,1,3,3,3,3,3,1,3,1,3,1},
        {1,3,1,3,1,1,1,1,1,3,1,1,1,1,1,1,1,3,1,1,1,3,1,3,1,1,1,1,1,3,1,3,1,1,1,3,1,3,1,1,1,3,1,3,1},
        {1,3,1,3,3,3,3,3,1,3,1,3,3,3,1,3,1,3,1,3,3,3,3,3,3,3,3,3,1,3,1,3,1,3,1,3,1,3,3,3,3,3,1,3,1},
        {1,1,1,1,1,3,1,3,1,1,1,3,1,1,1,3,1,3,1,1,1,3,1,1,1,1,1,3,1,1,1,3,1,3,1,1,1,1,1,1,1,1,1,3,1},
        {1,3,3,3,3,3,1,3,3,3,3,3,3,3,3,3,1,3,1,3,1,3,3,3,3,3,1,3,1,3,3,3,3,3,3,3,3,3,3,3,1,3,1,3,1},
        {1,3,1,1,1,3,1,3,1,1,1,3,1,1,1,3,1,3,1,3,1,3,1,1,1,3,1,1,1,1,1,1,1,1,1,3,1,1,1,1,1,3,1,3,1},
        {1,3,1,3,1,3,1,3,1,3,1,3,1,3,3,3,3,3,3,3,1,3,3,3,1,3,3,3,1,3,3,3,3,3,1,3,3,3,3,3,3,3,1,3,1},
        {1,3,1,3,1,3,1,3,1,3,1,1,1,1,1,3,1,1,1,1,1,1,1,3,1,1,1,1,1,3,1,1,1,3,1,1,1,1,1,3,1,3,1,3,1},
        {1,3,1,3,1,3,1,3,3,3,3,3,1,3,1,3,3,3,3,3,3,3,1,3,1,3,3,3,1,3,1,3,3,3,1,3,1,3,1,3,1,3,3,3,1},
        {1,3,1,3,1,3,1,1,1,3,1,1,1,3,1,1,1,3,1,3,1,1,1,1,1,3,1,1,1,1,1,1,1,3,1,3,1,3,1,3,1,1,1,1,1},
        {1,3,1,3,3,3,3,3,1,3,3,3,3,3,1,3,3,3,1,3,1,3,3,3,3,3,3,3,3,3,3,3,3,3,3,3,3,3,3,3,1,3,3,3,1},
        {1,3,1,1,1,1,1,3,1,3,1,1,1,1,1,1,1,1,1,3,1,3,1,3,1,1,1,1,1,1,1,1,1,3,1,1,1,1,1,1,1,1,1,3,1},
        {1,3,3,3,1,3,3,3,1,3,3,3,3,3,3,3,1,3,3,3,1,3,1,3,3,3,3,3,1,3,1,3,1,3,3,3,3,3,1,3,1,3,3,3,1},
        {1,1,1,3,1,1,1,1,1,1,1,1,1,1,1,3,1,1,1,1,1,1,1,1,1,1,1,3,1,3,1,3,1,3,1,3,1,3,1,3,1,3,1,3,1},
        {1,3,1,3,1,3,1,3,3,3,1,3,3,3,3,3,3,3,3,3,3,3,3,3,3,3,3,3,3,3,1,3,1,3,1,3,1,3,1,3,1,3,1,3,1},
        {1,3,1,3,1,3,1,1,1,3,1,3,1,1,1,1,1,3,1,3,1,1,1,1,1,1,1,3,1,1,1,3,1,3,1,3,1,3,1,3,1,3,1,1,1},
        {1,3,3,3,1,3,3,3,3,3,3,3,3,3,1,3,3,3,1,3,3,3,1,3,3,3,3,3,1,3,3,3,1,3,1,3,1,3,1,3,3,3,3,3,1},
        {1,1,1,3,1,1,1,3,1,1,1,1,1,3,1,1,1,3,1,1,1,1,1,1,1,3,1,1,1,3,1,1,1,1,1,3,1,1,1,3,1,1,1,3,1},
        {1,3,3,3,1,3,3,3,3,3,1,3,3,3,1,3,3,3,3,3,1,3,3,3,3,3,3,3,3,3,3,3,3,3,1,3,3,3,3,3,3,3,1,3,1},
        {1,1,1,1,1,1,1,1,1,1,1,1,1,1,1,1,1,1,1,1,1,1,1,1,1,1,1,1,1,1,1,1,1,1,1,1,1,1,1,1,1,1,1,1,1}};
        
 }
    
/**
 * Metodo que resuelve el laberinto usando backtracking
 * @param ren -- el numero de renglon de la casilla analizar
 * @param col -- el numero de columna de la casilla analizar
 * @return regresa true si la casilla es parte del camino y false cuando no lo es
 */
    public boolean crearRuta(int ren, int col) {
       
        return false;
    }
    
 
}
